A	AGGCGAGAGC
B	TCAAGATAGT
C	TAATTGACCT
D	CAGCCGGCTT
E	AGAACCGGAG
F	GAGATGCATG
G	GATTACCGGA
H	TCGTAACGGT